Shifter	しふたー	なし
WordPress.com	わーどぷれすどっとこむ	なし
エックスサーバー	えっくすさーばー	なし
チャプター	ちゃぷたー	なし
チャプター４	ちゃぷたーよん	なし
カフェのサイト	かふぇのさいと	なし
営業日	えいぎょうび	なし
My Calendar	まいかれんだー	なし
Jetpack	じぇっとぱっく	なし
Twenty Nineteen	とぅうぇんてぃーないんてぃーん	なし
カフェ	かふぇ	なし
カスタムリンク	かすたむりんく	なし
プライバシーポリシー	ぷらいばしーぽりしー	なし
カスタマイザー	かすたまいざー	なし
ソーシャルリンクメニュー	そーしゃるりんくめにゅー	なし
Twitter	ついったー	なし
Facebook	ふぇいすぶっく	なし
WordPress.org	わーどぷれすおーあーるじー	なし
ライセンス	らいせんす	なし
100%GPL	ひゃくぱーせんとじーぴーえる	なし
スライド	すらいど	なし
Sli.do	すらいどぅー	なし
リアルタイム	りあるたいむ	なし
Send	せんど	なし
識字率	しきじりつ	なし
ポモドーロテクニック	ぽもどーろてくにっく	なし
マシンパワー	ましんぱわー	なし
フリーランス	ふりーらんす	なし
SE	えすいー	なし
サムズアップ	さむずあっぷ	なし
パーマリンク	ぱーまりんく	なし
関西圏	かんさいけん	なし
ブロックエディター	ぶろっくえでぃたー	なし
ブロックエディタ	ぶろっくえでぃた	なし
GPL	じーぴーえる	なし
初学者	しょがくしゃ	なし
ウィジェット	うぃじぇっと	なし
カスタムHTML	かすたむえいちてぃーえむえる	なし
Alexa Champion	あれくさちゃんぴおん	なし
チャット	ちゃっと	なし
共有ボタン	きょうゆうぼたん	なし
iframe	あいふれーむ	なし
alignfull	あらいんふる	なし
フォーム	ふぉーむ	なし
フィードバック	ふぃーどばっく	なし
コピペ	こぴぺ	なし
ライブプレビュー	らいぶぷれびゅー	なし
公開ボタン	こうかいぼたん	なし
カスケーディングスタイルシート	かすけーでぃんぐすたいるしーと	なし
テンプレートタグ	てんぷれーとたぐ	なし
Alexa	あれくさ	なし
バナー	ばなー	なし
Hello World!	はろーわーるど	なし
Gutenberg	ぐーてんべるく	なし
サイドバー	さいどばー	なし
トップページ	とっぷぺーじ	なし
Twenty Nineteen	とぅうぇんてぃないんてぃーん	なし
Guntenberg	ぐーてんべるぐ	なし
クラシックエディタ	くらしっくえでぃた	なし
段落ブロック	だんらくぶろっく	なし
テーマ	てーま	なし
ドロップキャプス	どろっぷきゃぷす	なし
ドロップキャップ	どろっぷきゃぷす	なし
ドラック&ドロップ	どらっくあんどどろっぷ	なし
再利用ブロック	さいりようぶろっく	なし
Markdown	まーくだうん	なし
センタリング	せんたりんぐ	なし
点字	てんじ	アクセシビリティ
シンボル	しんぼる	アクセシビリティ
拡大印刷	かくだいいんさつ	アクセシビリティ
適応	てきおう	アクセシビリティ
方法	ほうほう	アクセシビリティ
提示	ていじ	アクセシビリティ
形式	けいしき	アクセシビリティ
入力	にゅうりょく	アクセシビリティ
モダリティ	もだりてぃ	アクセシビリティ
発作	ほっさ	アクセシビリティ
予測	よそく	アクセシビリティ
理解	りかい	アクセシビリティ
前景	ぜんけい	アクセシビリティ
代替コンテンツ	だいたいこんてんつ	アクセシビリティ
時間依存メディア	じかんいぞんめでぃあ	アクセシビリティ
フォーカス順序	ふぉーかすじゅんじょ	アクセシビリティ
キーボードトラップ	きーぼーどとらっぷ	アクセシビリティ
言語	げんご	アクセシビリティ
構文解析	こうぶんかいせき	アクセシビリティ
特定	とくてい	アクセシビリティ
キーボード操作	きーぼーどそうさ	アクセシビリティ
lang属性	らんぐぞくせい	アクセシビリティ
ステータスメッセージ	すてーたすめっせーじ	アクセシビリティ
一部分	いちぶぶん	アクセシビリティ
受託制作会社	じゅたくせいさくがいしゃ	アクセシビリティ
ズーム	ずーむ	アクセシビリティ
時代工房	じだいこうぼう	アクセシビリティ
反応	はんのう	アクセシビリティ
4.5:1	よんてんごたいいち	アクセシビリティ
PDF	ぴーでぃーえふ	アクセシビリティ
Flash	ふらっしゅ	アクセシビリティ
JIS	じす	アクセシビリティ
知覚可能	ちかくかのう	アクセシビリティ
操作可能	そうさかのう	アクセシビリティ
理解可能	りかいかのう	アクセシビリティ
堅牢	けんろう	アクセシビリティ
7:1	ななてんいち	アクセシビリティ
3:1	さんてんいち	アクセシビリティ
YouTube	ゆーちゅーぶ	アクセシビリティ
自分	じぶん	アクセシビリティ
場	ば	アクセシビリティ
デザイン	でざいん	アクセシビリティ
機能	きのう	アクセシビリティ
テキスト	てきすと	アクセシビリティ
挙動	きょどう	アクセシビリティ
入力支援	にゅうりょくしえん	アクセシビリティ
間違い	まちがい	アクセシビリティ
手段	しゅだん	アクセシビリティ
ユーザエージェント	ゆーざーえーじぇんと	アクセシビリティ
互換性	ごかんせい	アクセシビリティ
支援技術	しえんぎじゅつ	アクセシビリティ
乾杯	かんぱい	アクセシビリティ
将来	しょうらい	アクセシビリティ
ナビゲーション	なびげーしょん	アクセシビリティ
マークアップ	マークアップ	アクセシビリティ
構成	こうせい	アクセシビリティ
アプローチ	あぷろーち	アクセシビリティ
コンテンツ	こんてんつ	アクセシビリティ
HTML	えっちてぃーえむえる	アクセシビリティ
CSS	しーえすえす	アクセシビリティ
JavaScript	じゃばすくりぷと	アクセシビリティ
階層	かいそう	アクセシビリティ
リンク構造	りんくこうぞう	アクセシビリティ
解体	かいたい	アクセシビリティ
サブ動線	さぶどうせん	アクセシビリティ
位置づけ	いちづけ	アクセシビリティ
ページタイトル	ぺーじたいとる	アクセシビリティ
ケース	けーす	アクセシビリティ
制作	せいさく	アクセシビリティ
サイト	さいと	アクセシビリティ
お話	おはなし	アクセシビリティ
サイトマップ	さいとまっぷ	アクセシビリティ
ヘッダ	へっだ	アクセシビリティ
ヘッダー	へっだー	アクセシビリティ
フッタ	ふった	アクセシビリティ
フッター	ふったー	アクセシビリティ
セクション	せくしょん	アクセシビリティ
ワイヤーフレーム	わいやーふれーむ	アクセシビリティ
リンク	りんく	アクセシビリティ
ジェスチャ	じぇすちゃ	アクセシビリティ
ポインタ	ぽいんた	アクセシビリティ
プレースホルダー	ぷれーすほるだー	アクセシビリティ
フォーム	ふぉーむ	アクセシビリティ
セッションタイムアウト	せっしょんたいむあうと	アクセシビリティ
エラー	えらー	アクセシビリティ
配置	はいち	アクセシビリティ
スマホ	すまほ	アクセシビリティ
ホバー	ほばー	アクセシビリティ
縦積み	たてづみ	アクセシビリティ
ラベル	らべる	アクセシビリティ
読解	どっかい	アクセシビリティ
キャプション	きゃぷしょん	アクセシビリティ
見出し	みだし	アクセシビリティ
コンテキスト	こんてきすと	アクセシビリティ
ブロックスキップ	ぶろっくきゃっぷ	アクセシビリティ
左から右	ひだりからみぎ	アクセシビリティ
非テキストコンテンツ	ひてきすとこんてんつ	アクセシビリティ
わかりやすい文章	わかりやすいぶんしょう	アクセシビリティ
コンテンツエリア	こんてんつえりあ	アクセシビリティ
略語	りゃくご	アクセシビリティ
チェックリスト	ちぇっくりすと	アクセシビリティ
アクセシビリティ	あくせしびりてぃ	アクセシビリティ
デザイナー	でざいなー	アクセシビリティ
伊原	いはら	アクセシビリティ
伊原力也	いはらりきや	アクセシビリティ
ユーザー	ゆーざー	アクセシビリティ
対象	たいしょう	アクセシビリティ
ベストプラクティス	べすとぷらくてぃす	アクセシビリティ
移り変わり	うつりかわり	アクセシビリティ
Understanding	あんだーすたんでぃんぐ	アクセシビリティ
Webアプリケーション	うぇぶあぷりけーしょん	アクセシビリティ
UX	ゆーえっくす	アクセシビリティ
評議委員	ひょうぎいいん	アクセシビリティ
インクルーシブHTML	いんるーしぶ	アクセシビリティ
JIS X 8341-3	じすえっくすはちさんよんいちのさん	アクセシビリティ
freee	ふりー	アクセシビリティ
WCAG2.1	うぃーきゃぐにーてんいち	アクセシビリティ
ガイドライン	がいどらいん	アクセシビリティ
コントラスト	こんとらすと	アクセシビリティ
HCD-Net	えいちしーでぃーねっと	アクセシビリティ
ウェブアクセシビリティ基盤委員会	うぇぶあくせしびりてぃきばんいいんかい	アクセシビリティ
プロダクトマネジャー	ぷろだくとまねーじゃー	アクセシビリティ
アクセシビリティ対応	あくせしびりてぃたいおう	アクセシビリティ
勘所	かんどころ	アクセシビリティ
Webページ	うぇぶぺーじ	アクセシビリティ
Techniques	てくにくす	アクセシビリティ
利用者	りようしゃ	アクセシビリティ
ツッコミ	つっこみ	アクセシビリティ
作り手	つくりて	アクセシビリティ
達成基準	たっせいきじゅん	アクセシビリティ
気持ち	きもち	アクセシビリティ
植木	うえき	アクセシビリティ
フェーズ	ふぇーず	アクセシビリティ
代替テキスト	だいたいてきすと	アクセシビリティ
レイアウト	れいあうと	アクセシビリティ
原則	げんそく	アクセシビリティ
知覚	ちかく	アクセシビリティ
アクセシビリティ方針	あくせしびりてぃほうしん	アクセシビリティ
タスク	たすく	アクセシビリティ
状況	じょうきょう	アクセシビリティ
技術	ぎじゅつ	アクセシビリティ
実装	じっそう	アクセシビリティ
実際	じっさい	アクセシビリティ
メディア	めでぃあ	アクセシビリティ
観点	かんてん	アクセシビリティ
マサカリ	まさかり	アクセシビリティ
ユーザーインタフェース	ゆーざーいんたーふぇーす	アクセシビリティ
プロセス	ぷろせす	アクセシビリティ
スタイル	すたいる	アクセシビリティ
枠線	わくせん	アクセシビリティ
べからず集	べからずしゅう	アクセシビリティ
図版	ずはん	アクセシビリティ
Contrast	こんとらすと	アクセシビリティ
段階	だんかい	アクセシビリティ
行間	ぎょうかん	アクセシビリティ
エラー修正	えらーしゅうせい	アクセシビリティ
WAI-ARIA	うぇいありあ	アクセシビリティ
インタラクション	いんたらくしょん	アクセシビリティ
アクセシビリティシャン	あくせしびりてぃしゃん	アクセシビリティ
カルーセル	かるーせる	アクセシビリティ
再認証	さいにんしょう	アクセシビリティ
回避策	かいひさく	アクセシビリティ
プロトタイピング	ぷろとたいぴんぐ	アクセシビリティ
フォーカス	ふぉーかす	アクセシビリティ
端末	たんまつ	アクセシビリティ
センサー	せんさー	アクセシビリティ
入力欄	にゅうりょくらん	アクセシビリティ
ターゲット	たーげっと	アクセシビリティ
エラー	えらー	アクセシビリティ
タップ	たっぷ	アクセシビリティ
ビジュアルデザイン	びじゅあるでざいん	アクセシビリティ
エラー回避	えらーかいひ	アクセシビリティ
タイムアウト	たいむあうと	アクセシビリティ
文字	もじ	アクセシビリティ
閃光	せんこう	アクセシビリティ
パララックス	ぱららっくす	アクセシビリティ
閾値以下	いきちいか	アクセシビリティ
原典	げんてん	アクセシビリティ
再掲	さいけい	アクセシビリティ
音声解説	おんせいかいせつ	アクセシビリティ
順序	じゅんじょ	アクセシビリティ
関係性	かんけいせい	アクセシビリティ
原稿	げんこう	アクセシビリティ
制作者	せいさくしゃ	アクセシビリティ
パンくずリスト	ぱんくずりすと	アクセシビリティ
認知負荷	にんちふか	アクセシビリティ
文言なしリンク	もんごんなしりんく	アクセシビリティ
腕力	わんりょく	アクセシビリティ
背景音	はいけいおん	アクセシビリティ
発話	はつわ	アクセシビリティ
生産性	せいさんせい	アクセシビリティ
目の敵	めのかたき	アクセシビリティ
割り込み	わりこみ	アクセシビリティ
一貫性	いっかんせい	アクセシビリティ
アイコン	あいこん	アクセシビリティ
タイミング	たいみんぐ	アクセシビリティ
非依存	ひいぞん	アクセシビリティ
キーボード	きーぼーど	アクセシビリティ
字幕	じまく	アクセシビリティ
リアルタイム	りあるたいむ	アクセシビリティ
アニメーション	あにめーしょん	アクセシビリティ
音声	おんせい	アクセシビリティ
スパム	すぱむ	マーケティング
Gmail	じーめいる	マーケティング
Sendgrid	せんどぐりっど	マーケティング
ポート	ぽーと	マーケティング
実行	じっこう	マーケティング
PDO	ぴーでぃーおー	マーケティング
メタ構文	めたこうぶん	マーケティング
グラバター	ぐらばたー	マーケティング
キャッシュ	きゃっしゅ	マーケティング
Zapier	ざぴあー	マーケティング
下書き	したがき	マーケティング
サブミット	さぶみっと	マーケティング
企画	きかく	マーケティング
MySQL	まいえすきゅーえる	マーケティング
タイムアウト	たいむあうと	マーケティング
セールス	せーるす	マーケティング
Marketo	まるけと	マーケティング
ポップアップ	ぽっぷあっぷ	マーケティング
b→sash	びーだっしゅ	マーケティング
Mautic	まうてぃっく	マーケティング
zip	じっぷ	マーケティング
WP ZoomUP	だぶるぴーずーむあっぷ	マーケティング
展開	てんかい	マーケティング
ロリポップ!	ろりぽっぷ	マーケティング
Cron Job	くろーんじょぶ	マーケティング
WP Mautic	だぶるぴーまうてぃっく	マーケティング
ルート	るーと	マーケティング
SATORI	さとり	マーケティング
目的	もくてき	マーケティング
スキルセット	すきるせっと	マーケティング
キーワード	きーわーど	マーケティング
Webメディア	うぇぶめでぃあ	マーケティング
検索ボリューム	けんさくぼりゅーむ	マーケティング
流入	りゅうにゅう	マーケティング
トレンド	とれんど	マーケティング
WordPress	わーどぷれす	マーケティング
コンテンツ	こんてんつ	マーケティング
コンテンツ戦略	こんてんつせんりゃく	マーケティング
Meetup	みーとあっぷ	マーケティング
アソビュー	あそびゅー	マーケティング
セッション	せっしょん	マーケティング
コンテンツマーケティング	こんてんつまーけてぃんぐ	マーケティング
キーワード戦略	きーわーどせんりゃく	マーケティング
選定	せんてい	マーケティング
計測	けいそく	マーケティング
多拠点	たきょてん	マーケティング
オンラインプロダクト	おんらいんぷろだくと	マーケティング
HTML	えっちてぃーえむえる	マーケティング
デジタルノマド	でじたるのまど	マーケティング
フロントエンドデザイン	ふろんとえんどでざいん	マーケティング
サービス	さーびす	マーケティング
サイト	さいと	マーケティング
デジタルマーケティング	でじたるまーけてぃんぐ	マーケティング
月間	げっかん	マーケティング
PV	ぴーぶい	マーケティング
1000万PV	いっせんまんぴーぶい	マーケティング
順位	じゅんい	マーケティング
LINE	らいん	マーケティング
Googleトレンド	ぐーぐるとれんど	マーケティング
ニュースリリース	にゅーすりりーす	マーケティング
ホワイトペーパー	ほわいとぺーぱー	マーケティング
eBook	いーぶっく	マーケティング
ブログ	ぶろぐ	マーケティング
インバウンドマーケティング	いんばうんどまーけてぃんぐ	マーケティング
紙媒体	かみばいたい	マーケティング
重要度	じゅうようど	マーケティング
動画	どうが	マーケティング
冊子	さっし	マーケティング
PDF	ぴーでぃーえふ	マーケティング
ウェブページ	うぇぶぺーじ	マーケティング
検索エンジン	けんさくえんじん	マーケティング
ソーシャルメディア	そーしゃるめでぃあ	マーケティング
見込み顧客	みこみこきゃく	マーケティング
ステップ	すてっぷ	マーケティング
フロー	ふろー	マーケティング
キーワード選定	きーわーどせんてい	マーケティング
加味	かみ	マーケティング
変数	へんすう	マーケティング
複合的	ふくごうてき	マーケティング
リソース	りそーす	マーケティング
コンテンツリスト・スケジュール	こんてんつりすとすけじゅーる	マーケティング
優先順位	ゆうせんじゅんい	マーケティング
アウトライン	あうとらいん	マーケティング
ボリューム	ぼりゅーむ	マーケティング
マーケティング手法	まーけでぃんぐしゅほう	マーケティング
見込み客	みこみきゃく	マーケティング
ターゲティング	たーげてぃんぐ	マーケティング
プラグイン	ぷらぐいん	マーケティング
クーポン	くーぽん	マーケティング
高価格帯	こうかかくたい	マーケティング
高機能	こうきのう	マーケティング
アピール	あぴーる	マーケティング
SNS	えすえぬえす	マーケティング
お気に入り	おきにいり	マーケティング
レビュー	れびゅー	マーケティング
継続的接触	けいぞくてきせっしょく	マーケティング
アクティビティ	あくてぃびてぃ	マーケティング
AirBnb	えあーびーあんどびー	マーケティング
改修	かいしゅう	マーケティング
運用	うんよう	マーケティング
保守	ほしゅ	マーケティング
自然流入	しぜんりゅうにゅう	マーケティング
広告	こうこく	マーケティング
フォロー	ふぉろー	マーケティング
オーガニックサーチ	おーがにっくさーち	マーケティング
リファラー	りふぁらー	マーケティング
リダイレクト	りだいれくと	マーケティング
ダイレクト	だいれくと	マーケティング
アクセス	あくせす	マーケティング
食べログマガジンペルル.jp	たべろぐまがじんぺるるどっとじぇーぴー	マーケティング
Dazn	だぞーん	マーケティング
コンサルティング	こんさるてぃんぐ	マーケティング
口コミ	くちこみ	マーケティング
Hubspot	はぶすぽっと	マーケティング
外部ライター	がいぶらいたー	マーケティング
社内リソース	しゃないりそーす	マーケティング
Squarespace	すくえあすぺーす	マーケティング
Drupal	どるーぱる	マーケティング
Joomla	じゅーむら	マーケティング
トラフィック	とらふぃっく	マーケティング
CMS	しーえむえす	マーケティング
ブランド価値	ぶらんどかち	マーケティング
ブランディング	ぶらんでぃんぐ	マーケティング
ボクシルマガジン	ぼくしるまがじん	マーケティング
アクセス解析	あくせすかいせき	マーケティング
ライター	らいたー	マーケティング
Webライティング	うぇぶらいてぃんぐ	マーケティング
作文技術	さくぶんぎじゅつ	マーケティング
メルマガ	めるまが	マーケティング
Shopify	しょっぴふぁい	マーケティング
コミュニケーション	こみゅにけーしょん	マーケティング
イベントツール	いべんとつーる	マーケティング
自社製品	じしゃせいひん	マーケティング
ステップメール	すてっぷめーる	マーケティング
マーケティングオートメーション	まーけてぃんぐおーとめーしょん	マーケティング
MA	えむえー	マーケティング
サンプル	さんぷる	マーケティング
デモ	でも	マーケティング
解析フロー	かいせきふろー	マーケティング
ニュースメディア	にゅーすめでぃあ	マーケティング
運用フロー	うんようふろー	マーケティング
WordCamp	わーどきゃんぷ	マーケティング
質問大会	しつもんたいかい	マーケティング
ハッカソン	はっかそん	マーケティング
ハンズオン	はんずおん	マーケティング
検証	けんしょう	マーケティング
コワーキングスペース	こわーきんぐすぺーす	マーケティング
会場費	かいじょうひ	マーケティング
プロジェクター	ぷろじぇくたー	マーケティング
Wi-Fi	わいふぁい	マーケティング
Wi-Fi環境	わいふぁいかんきょう	マーケティング
関連キーワード	かんれんきーわーど	マーケティング
キーワードライフタイム	きーわーどらいふたいむ	マーケティング
チャプター	ちゃぷたー	マーケティング
コンテンツリスト	こんてんつりすと	マーケティング
反応	はんのう	マーケティング
WordCamp Haneda	わーどきゃんぷはねだ	マーケティング
KPI	けーぴーあい	マーケティング
KGI	けーじーあい	マーケティング
コンバージョン	こんばーじょん	マーケティング
目標設定	もくひょうせってい	マーケティング
カスタマー	かすたまー	マーケティング
購買行動	こうばいこうどう	マーケティング
仮説	かせつ	マーケティング
施策	しさく	マーケティング
施策	せさく	マーケティング
ユーザー	ゆーざー	マーケティング
類似キーワード	るいじきーわーど	マーケティング
